20 15 5 10 10
00000000000000000000
00000333333330000000
00003302222033000000
00033000000003300000
00330000000020330000
00332001111020330000
00332001111020330000
00332001111020330000
00332001111020330000
00330000000000330000
00033002222003300000
00003300000033000000
00000333333330000000
00000033333300000000
00000000000000000000
