1010100111100110011011100001101000101111011101000111011010010111
1110000110110110100001000100101110000010111001000011001111011100
0011001101011111001010100001000111100010100101001000100110001110
1101111111110011100010010110010111110110011101101001100001010111
1001101001000100110011110001110100100010011100000111001110001001
1100100100001100010000100101011100011111000001010101011110001000
0000101111000110000010100111111011001101001100011010001101110111
1100111111011010010110001010000111100011000011111000011011101100
1111001011001011111001001011110010011100000000001110100101010011
1010010011011111011011010000011001100110010101001011111110000000
1100101101000101111100101000111110101010100110000111011110111111
0111000110101111000101011111111101111111010000110101101110011001
0000001011100100101001001100010000110010010110001111110001000111
0101001111000110000110111111110111010011010000000000011001100100
1100110110101101011110111010111001100111001101010001000011000001
1100000111010001110010010001111000001001110110100110101111000001
1011000010111001110111001101001011001011110101101100101100000111
1100111101001010111001101101100011000100001110111100011110011101
1001100101001010011000011100011110111011111000001101110111111011
1110110101111100001111001011001100001001001001100111110011100101
1010101110001001100100100010001000111111011101000000101000010110
0010010110010000000100011001111110110110000011001110111101010100
0010011010110010101100010011110000101100101011100101001111111010
1000011111110111100110000010110101111011111101010110001010100011
0110110110000101101101111011111000001100001110111000101101001111
1010111111101100100110100101010100111011010000000100110100010101
0101110000011111111011001000010001111111111110001011010000110011
1010101101110100110001000101010011111000010101000001100100010000
0110101011101101000000001001011110011100101011101110101011111001
0000011111111101100100011101111101001110000010000101000010101000
0101100001011001101110000011110101011011010011011110110101010010
0000100011111011001001111100010100101000100101110011011111100001
1001100110000101100110111001000001100110000000010010000000010101
0010110000101100001010111100000011101001010110100001011110010110
1101100100111011000111101000010101001001001111100101000110011010
0111100000000101100011111101100000110011100111000011111111010000
0000110101010111001011000101101100000011011000000100010101011001
0110111011101010111100011110001010101011011011111111000110011011
1100101110110101111010001101101101110100001010010110000001010010
0101011101011010111100100101110011011110010001010000110101101110
1111110101001010111101101010010001010001100110001111011101001101
0001100100001011000010110001111110010001101011000010110101110110
0111100010011100000000001001000100010001101111110000001001100001
0110011101110010110001100111100010001010111011001010110100111110
0100111101100010011111011011101000100001100110001111011111111110
0101010011010000101111101110001111000000110001111001000110111101
0000101110001000010101111111110011100000001101001010011000111010
1011010011000101100001001110100000100101000000101101011110111001
1111000001000010001110001011111010111111000100001110100111100000
0010100110010100101100001010101110100101000110110100001111000011
0101101100101111111000001011111100110010111001011100011110011011
1010100100101101001011010110011011010100100110110110110100011100
0001111001101101001010010000111110001100010110101001100000000011
1010000010000010100100100010010110010011011111000010000100000010
0000111101000111000001101011010010001000101001101001110111011010
1110111011101010110100111010101010001010001011101101110001111010
1000111000001100000110001100001110001100101110010101101011101100
0010101001101110011111011010000100110011010011100100000011111010
1100111111101101100010111000101011000001011011110101111010111110
1000110101010010010011110001111011100101010110001101010010100010
1111001111001011110101001001001001011010001000001111110001100001
1011101010000101110011010101100100110000110100011101001001010001
0011110011000010110111010001011101110001111110010111110110001101
0101010001100101101000000111100011101000110111001101111100111110
